##########
#S        
#######   ##
#             #
#  E  #   
##########