###########
#S        #
## ####   #
#  # #    #  
#  E  #   #
###########