# Map
#####  ########
#S            #
#  #########  #
#  #       #  #
#  #  ###  #  #
#  #  #E#  #  #
#  #### ###  # 
#            # 
###############