#Map
#####
#S  #
#  ##
# E##
#####
#
