#Map
#######
#S#  ##
# #   #
# ## ##
#  #  #
##### #
#    ##
## ####
#E####
#######