############
#S        
#######   #
#           #
#  E  #   #
############