##########
#S ###   #
#  # # # #
## #  #E #
#  #   # #
#    #   #
##########